     NO      ./assets/wall_img.xpm
SO ./assets/greystone.xpm
WE ./assets/greystone.xpm
EA ./assets/greystone.xpm

F 220,100,0
C 225,30,0


        1111111111111111111111111
        1000000000110000000000001
        1011000001110000000000001
        1001000000000000000000001
111111111011000001110000000000001
100000000011000001110011111111111
11110111111111011100000000001
11110111111111011100000121001
11000000110101011100010000001
10000000000000001100100000001
100000000000000011010100N0001
1100000111010101111101110000111
11110111 1110101 101111010001
11111111 1111111 111111111111

